R  11950 11600
NO ./TXT/stark_logo.png
SO ./TXT/martell_logo.png
WE ./TXT/lannister_logo.png
EA ./TXT/baratheon_logo.png
S ./TXT/tyrion.png
C 0,0,50
F 40,40,10

111111
1200W1
111111