R 950 300
NO ./TXT/kadyk.png
SO ./TXT/kratos.png
WE ./TXT/navalny.png
EA ./TXT/batman.png
S ./TXT/kraios.png
C 0,0,200
F 10,10,10

111111111111111111111111111111111
1000000000000000S0000000000000001
111111111000000111111111111111111
111111111000000111111111111111111
111111111000000111111111111111111
100000000000000000000000000000001
100000000000000000000000000000001
100000000000000000000000000000001
100200000002000000000200000020001
111111111111111111111111111111111