R 1200 800
WE ./TXT/silent_hill_we.png
EA ./TXT/silent_hill_ea.png
SO ./TXT/silent_hill_so.png
NO ./TXT/silent_hill_no.png
C 250,0,0
F 0,250,0

                  11111111111111111
                  10000000000000001
                  10000011111000001
                  1000001   1000001
                  1000001   1000001
                  1000001   1000001
1111111111111111111000001   100000111111111111111111111
1000000000000000000000001   100000000000000000000000001
1000000000000000000000001   100000000000000000000000001
1000000000000000000000001111100000000000000000000000001
1000000000000000000000000000000000000000000000000000001
1011111111111111111000000000000000001111111111111111101
101               1000000000000000001               101
101               1000000000000000001               101
1011111111111111111000000000000000001111111111111111101
1000000000000000000000000000000000000000000000000000001
10000000000000000000W0001111100000000000000000000000001
1000000000000000000000001   100000000000000000000000001
1000000000000000000000001   100000000000000000000000001
1111111111111111111000001   100000111111111111111111111
                  1000001   1000001
                  1000001   1000001
                  1000001   1000001
                  1000001   1000001
                  1000001   1000001
                  1000001   1000001
                  1000001   1000001
                  1000001   1000001
                  1000001   1000001
                  1000001   1000001
                  1000001   1000001
                  1000001   1000001
                  1000001   1000001
                  1000001   1000001
                  1000001   1000001
                  1000001   1000001
                  1000001   1000001
                  1000001   1000001
                  10000011111000001
                  10000000000000001
                  11111111111111111
